.84|...|..5
3..|.9.|6..
2..|4..|.1.
-----------
..5|...|...
.6.|.1.|.8.
...|...|9..
-----------
.9.|..8|..2
..3|.2.|..7
4..|...|36.